    ###########
   ##         ##
  ##  * * * *  ##
 ##  * * * * *  ##
##  * * * * * *  ##
#  ******$******@.#
##  * * * * * *  ##
 ##  * * * * *  ##
  ##  * * * *  ##
   ##         ##
    ###########