          #####
         ##   ##
        ##  *  ##
     ####  *$*  ####
    ##    * * *    ##
   ##  * * * * * *  ##
  ##  *** * * * ***  ##
 ##  * * * * * * * *  ##
##  * * * * * * * * *  ##
#  * * * * * * * * * *  #
# * * *** *.*.* *** * * #
#  * * * * * * * * * *  #
##  * * * * * * * * *  ##
 ##  * * * * * * * *  ##
  ##  *** * * * ***  ##
   ##  * * * * * *  ##
    ##    * * *    ##
     ####  *$*  ####
        ##  *  ##
         ## @ ##
          #####