####################
#       .###########
# $$$$$$$#  ########
# $      #  ########
# $$$$$$ #  ###    #
#        #  ### ####
#$$$$$$$ #      ####
#           ### ####
####  ###  ####   ##
###   ###   ###  ###
##########    ##  ##
####        ###   ##
#     ###  ####   ##
#### ##########   ##
#### #########    ##
####      ###      #
#             ###  #
###########        #
###########   @#####
#                  #
####################
